8 8 8 8 8 8 8 8 8 8 8 8 8 8 8 8 8 8 8 8 8 8 8 8 8 8 8 8 8 8 
8 8 3 1 2 1 2 1 2 1 2 8 8 1 2 2 1 8 8 2 1 2 1 2 1 2 1 3 8 8 
8 8 1 8 8 8 8 2 8 8 1 8 8 2 8 8 2 8 8 1 8 8 2 8 8 8 8 1 8 8 
8 8 2 8 8 8 8 1 8 8 2 8 8 1 8 8 1 8 8 2 8 8 1 8 8 8 8 2 8 8 
8 8 1 2 1 2 1 2 8 8 4 2 1 2 8 8 2 1 2 4 8 8 2 1 2 1 2 1 8 8 
8 8 2 8 8 8 8 1 8 8 8 8 8 1 8 8 1 8 8 8 8 8 1 8 8 8 8 2 8 8 
8 8 1 8 8 8 8 2 8 8 8 8 8 2 8 8 2 8 8 8 8 8 2 8 8 8 8 1 8 8 
8 8 2 8 8 1 2 1 2 1 2 1 2 1 8 8 1 2 1 2 1 2 1 2 1 8 8 2 8 8 
8 8 1 8 8 2 8 8 8 8 1 8 8 8 8 8 8 8 8 1 8 8 8 8 2 8 8 1 8 8 
8 8 2 8 8 1 8 8 8 8 2 8 8 8 8 8 8 8 8 27 8 8 8 8 1 8 8 2 8 8 
8 8 1 2 1 2 1 2 1 2 1 2 1 2 1 1 2 1 2 1 2 1 2 1 2 1 2 1 8 8 
8 8 2 8 8 8 8 1 8 8 2 8 8 8 8 8 8 8 8 2 8 8 1 8 8 8 8 2 8 8 
8 8 1 8 8 8 8 2 8 8 1 8 8 8 8 8 8 8 8 1 8 8 2 8 8 8 8 1 8 8 
8 8 26 8 8 8 8 1 8 8 2 1 2 1 8 8 1 2 1 2 8 8 1 8 8 8 8 2 8 8 
8 8 1 2 1 2 1 2 8 8 1 8 8 2 8 8 2 8 8 1 8 8 2 1 2 1 2 1 8 8 
8 8 2 8 8 8 8 1 8 8 2 8 8 1 8 8 1 8 8 2 8 8 1 8 8 8 8 2 8 8 
8 8 1 8 8 8 8 2 8 8 1 2 1 2 1 1 2 1 2 1 8 8 2 8 8 8 8 1 8 8 
8 8 2 1 2 8 8 1 8 8 2 8 8 8 8 8 8 8 8 2 8 8 1 8 8 2 1 2 8 8 
8 8 8 8 1 8 8 2 8 8 1 8 8 8 8 8 8 8 8 1 8 8 2 8 8 1 8 8 8 8 
8 8 8 8 2 8 8 1 2 1 2 1 2 1 8 8 1 2 1 2 1 2 1 8 8 2 8 8 8 8 
8 8 1 2 1 8 8 2 8 8 8 8 8 2 8 8 2 8 8 8 8 8 2 8 8 1 2 1 8 8 
8 8 2 8 8 8 8 1 8 8 8 8 8 1 8 8 1 8 8 8 8 8 1 8 8 8 8 2 8 8 
8 8 1 8 8 8 8 2 8 8 1 1 1 1 1 1 2 1 2 1 8 8 2 8 8 8 8 1 8 8 
8 8 2 1 2 1 2 1 8 8 1 8 8 1 8 8 1 8 8 2 8 8 1 2 1 2 1 2 8 8 
8 8 1 8 8 2 8 8 8 8 1 8 8 2 8 8 2 8 8 1 8 8 8 8 2 8 8 1 8 8 
8 8 2 8 8 1 8 8 8 8 1 8 8 1 8 8 1 8 8 2 8 8 8 8 1 8 8 2 8 8 
8 8 1 8 8 4 1 2 1 2 1 8 8 2 1 1 2 8 8 1 2 1 2 1 4 8 8 1 8 8 
8 8 2 8 8 8 8 8 8 8 1 8 8 8 8 8 8 8 8 2 8 8 8 8 8 8 8 2 8 8 
8 8 1 8 8 8 8 8 8 8 1 8 8 8 8 8 8 8 8 1 8 8 8 8 8 8 8 1 8 8 
8 8 3 1 2 1 2 1 2 1 0 1 2 1 2 2 1 2 1 2 1 2 1 2 1 2 1 3 8 8 
8 8 8 8 8 8 8 8 8 8 8 8 8 8 8 8 8 8 8 8 8 8 8 8 8 8 8 8 8 8 
