8 8 8 8 8 8 8 8 8 8 8 8 8 8 8 8 8 8 8 8 8 8 8 8 8 8 8 8 8 8 
8 3 1 2 1 2 1 2 1 2 1 2 1 2 8 8 2 1 2 1 2 1 2 1 2 1 2 1 3 8 
8 1 8 8 8 8 8 1 8 8 8 8 8 1 8 8 1 8 8 8 8 8 1 8 8 8 8 8 1 8 
8 2 8 8 8 8 8 2 8 8 8 8 8 2 8 8 2 8 8 8 8 8 2 8 8 8 8 8 2 8 
8 1 8 8 8 8 8 1 8 8 8 8 8 1 8 8 1 8 8 8 8 8 1 8 8 8 8 8 1 8 
8 2 1 2 1 2 1 4 1 2 1 2 1 27 1 1 2 1 2 1 2 1 4 1 2 1 2 1 2 8 
8 1 8 8 8 8 8 1 8 8 2 8 8 8 8 8 8 8 8 2 8 8 1 8 8 8 8 8 1 8 
8 2 8 8 8 8 8 2 8 8 1 8 8 8 8 8 8 8 8 1 8 8 2 8 8 8 8 8 2 8 
8 1 2 1 2 1 2 1 8 8 2 1 2 1 8 8 1 2 1 2 8 8 1 2 1 2 1 2 1 8 
8 8 8 2 8 8 8 2 8 8 8 8 8 2 8 8 2 8 8 8 8 8 2 8 8 8 2 8 8 8 
8 8 8 1 8 8 8 1 8 8 8 8 8 1 8 8 1 8 8 8 8 8 1 8 8 8 1 8 8 8 
8 8 8 2 8 8 8 2 8 8 1 2 1 2 1 1 2 1 2 1 8 8 2 8 8 8 2 8 8 8 
8 8 8 1 8 8 8 1 8 8 2 8 8 8 8 8 8 8 8 2 8 8 1 8 8 8 1 8 8 8 
8 8 8 2 8 8 8 2 8 8 1 8 8 8 8 8 8 8 8 1 8 8 2 8 8 8 2 8 8 8 
8 8 8 1 2 1 2 1 2 1 2 8 8 8 8 8 8 8 8 2 1 2 1 2 1 2 1 8 8 8 
8 8 8 2 8 8 8 2 8 8 1 8 8 8 8 8 8 8 8 1 8 8 2 8 8 8 2 8 8 8 
8 8 8 1 8 8 8 1 8 8 2 8 8 8 8 8 8 8 8 2 8 8 1 8 8 8 1 8 8 8 
8 8 8 2 8 8 8 2 8 8 1 2 1 2 1 1 2 1 2 1 8 8 2 8 8 8 2 8 8 8 
8 8 8 1 8 8 8 1 8 8 2 8 8 8 8 8 8 8 8 2 8 8 1 8 8 8 1 8 8 8 
8 8 8 2 8 8 8 2 8 8 1 8 8 8 8 8 8 8 8 1 8 8 2 8 8 8 2 8 8 8 
8 3 2 1 2 1 2 1 2 1 2 1 2 1 8 8 1 2 1 2 1 2 1 2 1 2 1 2 3 8 
8 2 8 8 8 8 8 2 8 8 8 8 8 2 8 8 2 8 8 8 8 8 2 8 8 8 8 8 2 8 
8 1 8 8 8 8 8 1 8 8 8 8 8 1 8 8 1 8 8 8 8 8 1 8 8 8 8 8 1 8 
8 2 6 2 1 8 8 2 1 2 1 2 1 2 1 1 1 1 1 1 1 1 1 8 8 1 2 1 2 8 
8 8 8 8 2 8 8 1 8 8 2 8 8 8 8 8 8 8 8 2 8 8 1 8 8 2 8 8 8 8 
8 8 8 8 1 8 8 2 8 8 1 8 8 8 8 8 8 8 8 1 8 8 1 8 8 1 8 8 8 8 
8 1 2 1 2 1 2 1 8 8 2 1 2 1 8 8 1 2 1 2 8 8 1 1 1 1 1 1 0 8 
8 2 8 8 8 8 8 8 8 8 8 8 8 2 8 8 2 8 8 8 8 8 8 8 8 8 8 8 2 8 
8 1 8 8 8 8 8 8 8 8 8 8 8 1 8 8 1 8 8 8 8 8 8 8 8 8 8 8 1 8 
8 2 1 2 1 2 1 4 1 2 1 2 1 2 1 1 2 1 2 1 2 1 4 1 2 1 2 1 2 8 
8 8 8 8 8 8 8 8 8 8 8 8 8 8 8 8 8 8 8 8 8 8 8 8 8 8 8 8 8 8 
